{
  "Α": "A",
  "Β": "B",
  "Ε": "E",
  "Ζ": "Z",
  "Η": "H",
  "Ι": "I",
  "Κ": "K",
  "Μ": "M",
  "Ν": "N",
  "Ο": "O",
  "Ρ": "P",
  "Τ": "T",
  "Υ": "Y",
  "Χ": "X",
  "α": "a",
  "β": "b",
  "γ": "y",
  "δ": "d",
  "ε": "e",
  "ι": "i",
  "κ": "k",
  "ο": "o",
  "ρ": "p",
  "τ": "t",
  "υ": "y",
  "χ": "x",
  "ν": "v",
  "ϲ": "c"
}
